00000000000000100010
00000000000010100000
00000000000000000010
00000000000001001110
00000000000000100010
00000000000000100010
00010000000000100010
00010000000000100010
00000000000000100010
00000000000000100010
00000000000000100010
00000000000000100010
00000000000000100010
00000000000000100010
00000000000000100010