00000000000000100010
00000000000010100000
00000000000010000010
00000000000011111110
00000000000010100010
00000000000010100010
00000000000010100010
00000000000010100010
00000000000010100010
00000000000010100010
00000000000010100010
00000000000010100010
00000000000010100010
00000000000010100010
00000000000010100010